"700,-600",0,¥¥¥‹ó,1,¥¥¥’n–Ê,,,,,,,,,
1,0,5,0,0,0,0,0,0,0,0,0,0,9
0,0,0,0,0,0,0,0,0,0,0,0,0,9
0,0,0,0,0,0,0,0,0,0,0,0,0,9
0,0,0,0,0,0,0,0,0,0,0,0,0,9
0,0,0,0,0,0,0,0,0,0,0,0,0,9
0,0,0,0,0,0,0,0,0,1,1,1,1,9
1,1,1,1,1,1,0,0,1,1,1,1,1,9
1,1,1,1,1,1,1,1,1,1,1,1,1,9
1,1,1,1,1,1,1,1,1,1,1,1,1,-1
